
NO ./wall_textures/walls3/1.png
C 155,100,160
SO ./wall_textures/walls3/2.png
EA ./wall_textures/walls3/3.png
F                                       111,111,111
WE ./wall_textures/walls3/4.png

11111111111111111
10000001011000001
10000000000000001
10000000000000001
10000000000000001
11000000000000001
11000000W00000011
10000000000000001
10000000000000001
10000000000000001
10100000000001001
10000001110000001
11111111111111111
